16
16
0;1;114;83;100;102;103;101;112;113;0;1;2;3;4;5
87;81;129;117;0;0;0;0;0;0;0;0;0;0;0;0
0;0;0;0;0;0;0;0;0;0;0;0;0;0;0;0
34;0;35;0;36;0;118;0;199;208;0;0;160;161;162;163
99;86;85;84;96;98;97;82;80;0;0;67;68;69;70;71
0;0;0;1;6;7;16;17;0;0;0;1;22;23;32;33
116;115;0;1;18;19;20;21;198;0;0;1;132;130;133;131
37;119;54;128;38;39;48;49;0;0;0;1;51;53;50;52
55;66;64;65;0;0;0;0;0;0;0;0;0;0;0;0
164;165;166;167;176;177;178;179;180;181;182;183;196;0;0;0
192;193;194;195;197;0;0;0;0;0;0;0;0;0;0;0
134;135;144;145;146;147;148;149;150;151;0;0;0;0;0;0
0;0;0;0;0;0;0;0;0;0;0;0;0;0;0;0
0;0;0;0;0;0;0;0;0;0;0;0;0;0;0;0
0;0;0;0;0;0;0;0;0;0;0;0;0;0;0;0
0;0;0;0;0;0;0;0;0;0;0;0;0;0;0;0
