16
16
1;1;1;1;1;-1;-1;-1;-1;-1;-1;-1;-1;-1;-1;-1
1;1;1;1;-1;-1;-1;-1;-1;-1;-1;-1;-1;-1;-1;-1
1;1;1;-1;-1;-1;35;-1;-1;-1;-1;98;-1;-1;-1;-1
1;1;-1;-1;-1;-1;36;-1;-1;-1;-1;-1;-1;-1;-1;-1
1;-1;-1;-1;80;-1;-1;-1;-1;-1;-1;-1;-1;-1;-1;-1
-1;-1;-1;80;64;80;-1;-1;-1;-1;-1;-1;-1;-1;-1;-1
-1;-1;-1;-1;80;-1;-1;-1;-1;-1;-1;-1;-1;-1;-1;-1
-1;-1;-1;-1;-1;-1;-1;-1;-1;-1;-1;-1;-1;-1;-1;-1
-1;-1;-1;-1;-1;-1;-1;-1;-1;-1;-1;-1;-1;-1;-1;-1
-1;-1;-1;-1;-1;-1;-1;-1;-1;-1;-1;-1;-1;-1;-1;-1
-1;-1;-1;-1;-1;-1;-1;-1;-1;-1;-1;-1;-1;-1;-1;-1
-1;-1;189;190;191;-1;-1;-1;-1;-1;-1;-1;-1;-1;-1;-1
-1;-1;192;193;194;-1;-1;-1;-1;-1;-1;-1;-1;-1;-1;-1
-1;-1;195;188;197;-1;-1;-1;-1;-1;-1;-1;-1;-1;-1;-1
-1;-1;-1;-1;-1;-1;-1;-1;-1;-1;-1;-1;-1;-1;-1;-1
-1;-1;-1;-1;-1;-1;-1;-1;-1;-1;-1;-1;-1;-1;-1;-1
