16
16
0;0;0;0;0;0;0;0;0;0;0;0;0;0;0;0
0;1;1;1;1;1;1;1;1;1;1;1;1;1;1;0
0;1;1;1;1;1;1;1;1;1;1;1;1;1;1;0
0;1;1;1;1;1;1;1;1;1;1;1;1;1;1;0
0;1;1;1;1;1;1;1;1;1;1;1;1;1;1;0
0;1;1;1;32;1;33;1;34;1;1;1;1;1;1;0
0;1;1;1;1;1;1;1;1;1;1;1;1;1;1;0
0;1;1;1;1;1;1;1;1;1;1;16;1;1;1;0
0;1;1;1;1;1;1;1;1;1;1;18;1;1;1;0
0;1;1;13;14;1;1;1;1;1;1;20;1;1;1;0
0;1;1;21;22;1;1;1;1;1;1;1;1;1;1;0
0;1;1;29;30;1;1;40;41;42;1;1;1;1;1;0
0;1;1;37;38;1;1;48;49;50;1;1;1;1;1;0
0;1;1;45;46;1;1;56;57;58;1;1;1;1;1;0
0;1;1;1;1;1;1;1;1;1;1;1;1;1;1;0
0;0;0;0;0;0;0;0;0;0;0;0;0;0;0;0
